*************************************************************************************************************************
*         *          *   *   *   *   *       *               *                   *     *                 *   *         *
********* *****      *     *   *   *      *  *   **********  *  ***************  *           **********  *      *   ****
*       *            **********************  *   *        *  *  *         *      *************       *   ********   *  *
*   *****   ******   *   *        * *     *  *********    *  ****      *     *   *           *    *      *          *  *
*   *       *  *     *   *     *  *    *             *  ***         **************    *      *  **********  *********  *
*   *********  *     *         *  *    *  *******    *          *      *        *     *********      *                 *
*   *            **********   **  ******  *          ******     *          *          *    *         ***********    ****
*   * ********    *       *           *   *  *********       **************************    *  ********     *        *  *
*   *        *            **********  *   *  *                 *                                     *     *        *  *
** ********  *   **********           *      ************      *           **********   ****          *******       *  *
*         *  *            *     *     *             *       ************       *         *     ********       *****    *
*   *******  ********************     ********      *         *    *           *         *         *              *  ***
*        *        *                    *     *  ***********   *    *******     *   *************   *    *****     *    *
*   *        *    **********  *************  *                         *           *         *     *        *     *    *
*   ***************               *          *     *****************   *    ***************  ****  *        *          *
*        *        *    *    *************    *     *             *     *    *             *        *     ***************
***  *   *   *    *    *          *          *                   *     ****************   *    *****       *           *
*    *   *   *    ***********     *   ********  ********   *************   *          *            *   *   ******      *
* ****  ******    *               *                 *      *               *       *  ************     *               *
* *  *            *   *           *    *****  *******   *  ******     ********     *             *   **********    *****
* *  **** *********   *   *********    *                *       *          *     ***********     *            *        *
* *            *      *                *      ***********  *    *     *    *             *    *******      *********   *
* *********    *    **********   *     *  *****     *      *  *********  **********      *       *                *    *
*       *      *    *            *     *      *     *  *****     *                *   ********   *  **********    *    *
*    *  *           *   ***********************     *     *      *     *******    *        *     *     *          *    *
******  *************   *        *                  *     *      *       *      ********   *  ******   *  *********    *
*       *     *         *   ******      **********************           *      *          *     *     *     *         *
*  ******     *     *****   *             *           *      ********  *****    *   *********   ***********  *    ******
*             *             *      * *********     *           *    *  *        *           *      *         *         *
*    **********      ***************      *  **************    *    *  *   ***************  ****   *     ************  *
*           *                      *      *             *      *       *          *           *    *             *     *
*********   *  ********    *       *   ********    ***  *  *****  **************  *    ********  *************   *     *
*           *    *    **********   *   *      *    *    *    *     *      *       *           *              ** ** *****
*           *    *            *    *  *****   *    *  *** ****     *  *   *      ***          **********  *            *
*   *********************     *    *               *                  *   ******   ********            ** **********   *
*        *      *    *        *    *    ********************          *        *          *                    *       *
******   *           *    *****                *           ***************     *          ******************           *
*        **********  *          ************   *     *       *         *    ********      *                *******     *
*                 *  *******        *                *       *    *    *       *                    *      *           *
***************   *      *    *    **  ******************    *    *  ***********   ************     *      *           *
*                 *  ******** * ****             *           *    *      *        **   *      *     ************* ******
*   ***************         * *    *       *     *    *************      *     ****    *      *                        *
*     *        *  ********  * ******       *     *         *             *        *           *         *         *    *
*     *    *   *    *       *    *     *   *     *******   *********     *   **************** *    **********     *    *
*     *    *   *    *    **********    *******   *     *   *             *        *         *         *     *  *********
*     *    *        *                                  *   *                      *     *   *****           *     *    *
*     *********     **********   ******   ********************** *******   **********   *       *********   *          *
*          *     *   *       *     *  *        *    *         *        *       *    *********           *    *******  **
****** *****     *           *  *     *    *   *    *      **********  *       *            *********      *     *     *
*      *        **********   ****************  * *********         *   *     ************           * ******     *  ****
*  *****   *             *   *              *    *     *      *        *                *   *****   *            *     *
*      *   *      ********      *********        *     ********   *****************     *      *        ****************
*          *             *        *    *    ******          *        *     *      *     *   ********              *    *
*******************      *        *    *        *    ************    *     *  *   * *****          **********     *    *
*  *         *    *      *             *        *            *       *     *  *        *                *   *       *  *
*  *    *    *    *****************    *   ***************   ****** **  ****************   *********    *   *  ******  *
*       *                              *       *      *             *      *   *               *   *    *  *****       *
*       *              *               *       *               *        *      *      *        *        *         *    *
*************************************************************************************************************************